aa=A
ae={
ah=V
ao=O
aw=aU
ax=@
ay=aI
br=
ch=tS
cl=
dh=D
dr=dZ r
dx=4
eh=E
er=3
ey=eI
hh=h
ih=I
iy=i
jh=dZ
ng=N
ow=oU
oy=OI
pau=
sh=S
sil=
th=T
tr=tS r
uh=U
uw=u
zh=Z
y=j
