aa r=Q@
aa=Q
ae={
ah=V
ao r=O@
ao=O:
eh r=e@
eh=e
er=@r
ih r=I@
ih=I
iy r=I@
iy=i:
uh r=U@
uh=U
uw r=U@
uw=u:
aw=aU
ay=aI
ey r=e@
ey=eI
ow r=O@
ow=@U
oy=OI
ch=tS
dh=D
hh=h
jh=dZ
ng=N
sh=S
th=T
y=j
z=z
zh=Z
