aa r=Q@
aa=Q
ae={
ah=V
ao r=O@
ao=O:
aw=aU
ax=@
ay=aI
eh r=e@
eh=e
er=@r
ey r=e@
ey=eI
ih r=I@
ih=I
iy r=I@
iy=i:
ow r=O@
ow=@U
oy=OI
uh r=U@
uh=U
uw r=U@
uw=u:
ch=tS
dh=D
dr=dh r
dx=4
hh=h
jh=dZ
ng=N
sh=S
th=T
tr=th r
y=j
zh=Z
br=br1
cl=Asp
pau=Sil
sil=Sil
